11111111111
1E0001001C1
11010100001
1001010C111
1C0100000P1
11111111111
