11111111111111
10C00000000101
11011000100101
11101001001001
1P101000111011
10000CC00000E1
11111111111111
